00XX0000000000
00XX00X0000000
00XX000X000000
00XX0000X00000
00XX00000X0000
00XX000000X000
00XX0000000X00
00XX00000000X0
00XX000000000X
00XX000000000X
00XX000000000X
00XX00000000X0
00XX0000000X00
00XX000000X000
00XX00000X0000
00XX0000X00000
00XX000X000000
00XX00X0000000
00XX0000000000