ASGXQQS1211S0
G0G1GQ1QX2AAX
1XGG2AGA2GQQA
B0X0S0B0SAS00
20Q2SGQ1XQQQG
XQ1XB2SSQGSSS
B2AG1GQX0XAQ2
QG12SG00B01SX
GXASSAQXXXGG2
SQS01220S0QSS
GXS22B0A1QAAA
G2BSGQ1B22B1B
