GB0S1QAB21XXX
XBSA202XGQ202
100A0GX0X1GGQ
S2XGAS00QAXX0
SGSQAXAB1ABSG
0GS0QGGAXAAGS
GGG2AAGQ0ABG1
21BXXAAAGAQ01
