00BB00000000000
00BB00B00000000
00BB000B0000000
00BB0000B000000
00BB00000B00000
00BB000000B0000
00BB0000000B000
00BB00000000B00
00BB000000000B0
00BB000000000B0
00BB000000000B0
00BB00000000B00
00BB0000000B000
00BB000000B0000
00BB00000B00000
00BB0000B000000
00BB000B0000000
00BB00B00000000
00BB00000000000