00BB00000000X00
00BB00B00000X00
00BB000B0000X00
00BB0000B000X00
00BB00000B00000
00BB000000B0000
00BB0000000B000
00BB00000000B00
00BB000000000B0
00BB000000000B0
00BB000000000B0
00BB00000000B00
00BB0000000B000
00BB000000B0000
00BB00000B00000
00BB0000B000B00
00BB000B0000B00
00BB00B00000B00
00BB00000000B00