
BB000B0000X00
BB000X00BX000
BB00B0000X000
BB00B0B0000B0
BB00X0B0X0000
BB0000000XB00
BB000BX000B00
BB000000B000X
BB00BB0000000
BB000000XX000
BB00B00000000
BB000XX0X0B00
BB000B0000X0B
BB0000X0BBX00
BB000000X0X00
BB00B0000000B
BB00000B0BB00
BB0000B00X000
BB00X0X00XB00
BB0000X00B000
BB0000000B0X0
BB000XBBB000X
BB000000000X0
BB00000X000BX
BB00000X00B00
BB00000XX000X
BB000B0B000XX
BB000X000X000
BB000B00000X0
BB00B00B00000
BB0000B000BX0
BB00X00000000
BB0000B000000
BB00B000B0000
BB00B000X0000
BB0000000000B
BB0000X0000B0
BB0000B00B0BX
BB000X00B0000
BB000000B0000
BB0000B000X00
BB00000XBX000
BB0000B00000X
BB0000B0X00B0
BB0000X00B00X
BB000000X000B
BB000000BX0BX
BB00000000000
BB0000000000B
BB00000000X0X
BB000000BX000
BB000X000BB0B
BB00BXB000000
BB000000B0000
BB00X0XBB0X0X
BB000000B0000
BB000B000X000
BB0000000X000
BB000X0XB0000
BB000X000X0BB
BB0000BX0B000
BB00B0X000000
BB0000B000000
BB00XB00000B0
BB00X00000000
BB0000X00000B
BB000X00X0000
BB000XBB0000B
BB0000000000X
BB0000B00X000
BB00X00000B00
BB00X0BBBB0XX
BB000BB0B00BB
BB000X00000X0
BB0000X00X000
BB0000000000B
BB00BB00X00X0
BB00000X00000
BB00X00XX0XX0
BB00X0000000B
BB00X0X000B00
BB000000B0X0X
BB00000B0BB00
BB000X0000000
BB000B000X000
BB000XBX000X0
BB0000BB0000X
BB000B0B0XX00
BB00000000000
BB00X0000B000
BB00000B0XBX0
BB0000BB00B0X
BB00B0000000B
BB000000B0000
BB00000X0BB00
BB0000X0XX0X0
BB0000X0000B0
BB00BX0X00X00
BB000X000000B
BB00000XX000X
BB00000000000
BB00X0B0X0000
BB0000000X000
BB000X0X000B0
BB0000BX00000
BB000BXXX00XX
BB0000000X00X
BB0000B0000XB
BB000X0000B0B
BB00B0X0B0000
BB000XB000000
BB0000000000X
BB000000B0000
BB00000X0000B
BB0000000X000
BB0000BX00X0X
BB0000000X00B
BB00000000B00
BB000000B0000
BB00000000B00
BB00000BB0B00
BB000000000X0
BB00000X00000
BB0000000000X
BB0000000X00X
BB0000BB0B000
BB000BBX0X000
BB000000000X0
BB000X00000XX
BB0000000XX00
BB00B00000000
BB00000000XX0
BB000000BX0B0
BB0000000X000
BB00000000000
BB00BBB000000
BB0000B00X0B0
BB00BB0B0B0B0
BB00000000000
BB000X0X00X0B
BB0000B0000X0
BB000X00000B0
BB000B0X00000
BB000B0X000B0
BB00000000000
BB0000000000B
BB00000000000
BB00BB00B00XB
BB00000X00X0B
BB000B0000000
BB000B000B000
BB000XB0B0000
BB00X000000B0
BB0000000000B
BB0000X000000
BB000000000B0
BB0000X0000B0
BB00XX000B000
BB000XB00000X
BB00B00B00000
BB000B00BX000
BB000X00000B0
BB0000B0X0000
BB000BBB0B00X
BB000B00XB0XB
BB000BXX0B00X
BB0000B000BB0
BB000B0X0000X
BB00B00B0X00X
BB000B0B00B00
BB000X00X0000
BB000XXB00000
BB00X0B00XX00
BB00X0000000B
BB000B0X000X0
BB0000000BX00
BB000XB000000
BB00X000B0000
BB00000000000
BB00B0X000B0B
BB00XBB0X0000
BB00B0B0BX000
BB000B000B00B
BB000X0000000
BB000BX0XB000
BB000000000X0
BB000000X0B0B
BB00X0BX00X00
BB00B0X0000B0
BB0000000BX00
BB0000XX00B00
BB000000X0000
BB00X00000000
BB0000X00XB00
BB00000000000
BB00X00B0XB00
BB000B00000B0
BB00000BB000X
BB00X0B00B000
BB00B00000000
BB0000BX00000
BB000X0000X00
BB000X0000BX0
BB000000000B0
BB0000000B00X
BB000BX000B00
BB000B00BXBBB
BB00B0B000XB0
BB00XXX0000X0
BB00B0B000000
BB00B0000X00X
BB00XX00B00X0